
F 0,255,0

NO ./texture/north
SO ./texture/south

C 0,0,255

R 1920 1080

WE ./texture/west
EA ./texture/east

11111111
10000001
10000001
100000E1
10000001
11111111
