
F 0,255,0

NO textures/lichen.xpm
SO textures/lichen.xpm

C 0,0,255

R 1360 768

WE textures/lichen.xpm
EA textures/lichen.xpm

11111111
10000001
10000001
100100E1
10010001
11111111
