
F        220,100,0
C 225,30,20
WE            ./texture/west
EA./texture/east
NO		./texture/north
SO                         ./texture/south


R 1920 1080

1111111111111111111111111111111111111111111111111111111111111111111111
1011000000000001000111100000011100101000000100010100010100000010100011
110S001000000001001001000010011010000001000001100000001100000001100101
1100011101100001101101010100100010011100000000000000100000001100000001
1100110000010010000000010100000001000000011001000001000000000010011011
1000001100100000000010110000000000000100100100101100010001101000010001
1000101010100010000010100010000001000000000000001001100000000001100001
1000010001010000000000000000000000000000000000111000000101001001001101
1010001010000100000000000000000111000110000010001100110000000001011001
1000001011100010000000000000100100001100111010000000011000010010000001
1000011000000111101000010100001010000000001000001010001110001000001001
1000000100101001100100000000100110000010000100000000000101000000011101
1000101101110110010100001111110000010011010001100000000000001000110101
1000010000001010001101001000000111000000100000101011100010001001100001
1000110000010000000010110001000000101100001010011000000000010000000001
1001000010001000010101010001001000000100000001010001001001101010001101
1100010001010101000110001010011101100000110100010010000100000000101101
1000101011000000010000000010000100100101010010011110001100000001000001
1110001000000010000001100000000000101010000100001110000100101101001001
1000011000000000000010000110101010100000111010010100100101000000000101
1010000000000101000000010101001010110110000000010010000100101000100001
1000010000000110000101000100000000010010000101010000000001011010000001
1110000010000001000100100100000010101011100010001100001100010010010001
1001010100000010000001100000010000000000001100100000101000100001100101
1001000000000001010010000010000001000000001000010111101001000001100001
1101010000000000000100000100000001000100000000100010000101000010000001
1110001001000000100000011000100000100000000001000010000000100101100011
1001100000000000000001010011010000110001010100111111000000110010101001
1000001010001000110001000000100100110001111000000000111100000000001101
1111100001001000000000001000100000000000100010100000000000011000110111
1001000101010101000000000001000010010101100000100011000000000000001001
1000000000010011001100000000000010000000001000110010010000000100000001
1001100000001011000000000110000010010000000000000000000000000000000001
1000111100100111100001000000000100010000010010010000001000000000100001
1101010100000000100000000000010000000001000001001000000101000001110101
1001100101100000100000110001011010100011000001100100000000011100011011
1100000001010100110001001000000101101100100001101011110000000000010011
1010010101001100100000100000000000101000000010010100000001010001010011
1100011001000100111011000100010000001000100000110001001000000101110111
1100000000001000100001000101110001101001000100000010000000000001111011
1010101000010110110000000100011110100011000010110000110000000000010011
1000000000100000101000010000101011000101000010110011101010000111010111
1000010001000000100110000001001000011001001000110001001000000000010011
1010000000000000111111111111111111111111111111111111111111111111111011
1000001001000000100000100000000100010000101000000001000000010000001011
1000000010100000000000000000000100111100001010001000000010000000000011
1100101111111111111111111111111111111111111111111111111111111111111111
1000010000100000000001001010001000001100001110100000000001000000000011
1111111100000000000000100000000010010100001100100000000010100000010001
1010000010110000100001000011001001010110000000011110100110101001000111
1100000100001100010000001100000100000000000000011011010100000010110011
1000100000000101000000110000101000010000110011101001010100000000100011
1001000100100000001011010101000000010000010001101001100100010010111001
1101001101000001000100000001100000010000001000000010001101001101000011
1011001010101010001000011001000010000000110100010100100010001010000001
1000000000101001001000010101000001000000100010000100001001000000000011
1100000000010110000010000000100010000000011011000000000000000100000001
1010010010010000000101100110101010110000010010000001000000000000011001
1000100100110001010010101010010000100010000011010010010000001010100011
1000111000000000001010000000000000000000000011000000100001100001000001
1001000001001110000100001000110001100000001110010011010001001001000001
1000000011100100100000000000000100000000100010001101000001000000010001
1000101000110000000000000000001000100010000000011000100001010010000001
1101000001000010101000000101100100010010000010000100100001000001000001
1000011000001000010010010000000000000000100000000000010000100100000011
1000000000101000011011110000100100110001000000000000000000000001000011
1001011000100100010101000000000000100010000000101000100010000001000101
1100000000100010010000010100000010000001000000000101000000110101001001
1101010001011100000000000000100000000000000010100011101000000010010011
1000000000000000001001000000100100010000110000001000001001000000000011
1001010011001011010111001000000001001000011000010000100100100110111001
1011010100100101010010000101011000000010101001001000010101010000000111
1000100010001000000101000100000001010001010000101000000000100000001001
1011000000011000100100101000101000000101011100000000000000000100000001
1010000000100000000000001011110101000001101000000100001100101100101101
1011000000000110000000100100011000000010000100100010100011101001000011
1001100000100000001001000000000000000100010001111000001000101000010001
1000110010000001101001000000001010000010010011000000000001010000000001
1100000000001100000010001001000101010011000010001100000000100011100011
1111111111111111111111111111111111111111111111111111111111111111111111
