
F        220,100,0
C 225,30,20
WE            ./texture/west
EA./texture/east
NO		./texture/north
SO                         ./texture/south
R 1920 1080

   	11111111111111111
    111111100000000001
1111100000000000011111
100S000000001111111
1000000111111
11111111
