
F        220,100,0
C225,200
WE            ./texture/west
EA./texture/east
NO		./texture/north
SO                         ./texture/south

         1111111111111111
        00000000001
1111100000000000011111
100000000N1111111
1000000111111
11111111
