
F        220,100,0
C225,200,50
WE            ./texture/west
EA./texture/east
NO		./texture/north
SO                         ./texture/south

0
11111111111111111111111111111111
  11110000000000000000000000001
     11100000000001000000000001
11111000000000000111110111111111111
100000000N11111110000001
100000000011100000011111
111111111100000000111
111111111111111111111
