
F        220,100,0
C225,200,50
WE            ./texture/west
EA./texture/east
NO		./texture/north
SO                         ./texture/south

11
   00011111111111110000000000
     1110000000000100000000000
11111000000000000111110
100000000N1111111000000
1000000000111000000
111111111100000000
